ARMbot	KEYWORD1
init 	KEYWORD1
begin	KEYWORD1
Robot	KEYWORD1
enable_rc	KEYWORD2
disable_rc	KEYWORD2
bip	KEYWORD2
blinks	KEYWORD2
led_off	KEYWORD2
led_on	KEYWORD2
setLed	KEYWORD2
checkValue	KEYWORD2
readPot	KEYWORD2
start	KEYWORD2
setBase	KEYWORD2
setShoulder	KEYWORD2
setElbow	KEYWORD2
setGrip	KEYWORD2
moveArm	KEYWORD2
readButton	KEYWORD2
